preset: 30 30 50 50 50 (MapSizeX--MapSizeY--boxLocationX--boxLocationY--boxSize)
excludedItems: MiniHealthFlask DivinePotion FullPotion SpicyBiscuit PlasmaAmmo Wheels
x x x x x x x x x x.x x x x x x x x x x.x x x x x x x x x x
+ _ _ _ _ _ _ _ _ _._ _ _ _ _ _ _ _ _ _.x x x _ _ _ _ _ _ +
+ _ 1 _ _ _ _ _ _ _.s 1 _ _ _ _ _ _ _ _._ _ _ _ _ _ s s _ +
+ _ _ _ _ x x x x _.s 1 _ x x x _ _ _ _._ _ s _ x x _ _ _ +
+ _ 1 _ _ _ _ _ _ _.s _ _ x x x _ _ _ _._ _ s _ x x _ _ _ +
+ _ _ + _ a _ _ _ +.x x x x x x x x x x.x x x x x x _ _ _ +
+ _ _ + _ _ _ _ _ +.x x x x x x x x x x.x x x x x x _ _ _ +
+ _ _ _ _ _ _ _ _ +._ _ s _ _ _ _ _ _ _._ _ _ _ _ _ _ _ _ +
+ _ _ + _ _ _ _ _ +._ _ _ _ _ _ _ _ _ _._ _ _ _ _ _ _ _ _ +
+ _ _ + _ _ _ + _ +._ _ _ s s s s _ + +._ _ _ _ + + _ _ _ +.
+ _ _ _ _ _ _ + _ +._ _ _ s s s s _ + +._ _ _ _ + + _ s _ +
+ _ _ _ _ x x x _ +._ _ _ _ _ _ _ _ + +._ _ _ _ + + _ _ _ +
+ _ _ _ + + _ _ _ +._ _ x x x x x x x x.x _ _ _ + + _ s _ +
+ _ _ _ + + _ _ _ +._ _ + _ _ _ _ _ _ _.s + _ _ + + _ _ _ +
+ _ _ _ + + _ _ _ _._ _ + s s s s _ _ _.s + _ _ + + _ s _ +
+ _ _ _ + + _ _ + _.s _ _ s s s s + _ _._ _ _ _ + + _ _ _ +
+ _ s _ + + _ _ + _.s _ _ _ _ _ _ + _ _.+ _ _ _ + + _ _ _ +
+ _ _ _ + + _ _ _ x.x x x x x x x x _ _.+ _ _ _ + + _ _ _ +
+ _ s _ + + _ _ _ _.+ + _ _ _ _ _ + _ _.+ _ x x x _ _ _ _ +
+ _ _ _ + + _ _ _ _.+ + _ s s s s _ _ _.+ _ + _ _ _ _ _ _ +.
+ _ s _ + + _ _ _ _.+ + _ s s s s _ _ _.+ _ + _ _ _ + _ _ +
+ _ _ _ _ _ _ _ _ _._ _ _ _ _ _ _ _ _ _.+ _ _ _ _ _ + _ _ +
+ _ _ _ _ _ _ _ _ _._ _ _ _ _ _ _ s _ _.+ _ _ _ _ _ _ _ _ +
+ _ _ _ x x x x x x.x x x x x x x x x x.+ _ _ _ _ _ + _ _ +
+ _ _ _ x x x x x x.x x x x x x x x x x.+ _ _ _ b _ + _ _ +
+ _ _ _ x x _ _ _ _._ _ _ _ x x x _ _ _._ _ _ _ _ _ _ _ _ +
+ _ _ s x x _ s _ _._ _ _ _ x x x _ _ _.s x x x x _ _ _ _ +
+ _ _ s _ _ _ s _ _._ _ _ _ _ _ _ 2 2 _.s _ _ _ _ _ 2 2 _ +
+ _ _ _ _ _ _ x x x._ _ _ _ _ _ _ _ _ _.s _ _ _ _ _ _ _ _ +
x x x x x x x x x x.x x x x x x x x x x.x x x x x x x x x x
